1111111111111111111111111111111
1000100010001002001000100010001
1000100010001000001000100010001
1000000000000000000000000000001
1111101111111011111111111110111
1000000000000000000000000000001
1000000000000000000000000000001
1000000000000000000000000000001
1000000000000000000000000000001
1000000000000000000000000000001
1000000000000000000000000000001
1000000000000000000000000000001
1000000000000000000000000000001
1000000000000000000000000000001
1000000000000000000000000000001
1000000000000000000000000000001
1000000000000000000000000000001
1000000000000000000000000000001
1000000000000000000000000000001
1000000000000000000000000000001
1000000400000400000000000000001
1400400004000004000000000000031
1111111111111111111111111111111
