0000000000000004000000000000000
0111111111111111111111111111110
0100000000000000000000000000010
0102000000000000000000000002010
0100000000000000000000000000010
0111111111111110111111111111110
0100000000000000000000000000010
0100000000000000000000000000010
0100000001110000000111000000010
0100000000010000000100000000010
0100000000010000000100000000010
0111111100010000000111111100010
0100000000010000000100000000010
0100000000010000000100000000010
0100011111110000000100011111110
0100000000011111111100000000010
0100000000011111111100000000010
0100000000000000000000000000010
0100000001000000000001000000010
0100000001000003000001000000010
0100000011100000000011100000010
0111111111111111111111111111110
0000000000000000000000000000000
