1000000000000020000000002000001
0111111110111110111110111111110
0100000010000000100000100000010
0101110010111100101110101110010
0100010000100000000010000010010
0100011110101111111011111010010
0100000000101000001010000010010
0111111011101011101010111111010
0100001000001010000010000000010
0101101111101010111110111110010
0101000000100010000010000010010
0101011110111110111011111010010
0100010000100000100010001010010
0111010111101111101110101011010
0100010100001000000010101000010
0101110101111011111010101111010
0100000101000010001010100000010
0101111101011110101010111111010
0100000001000000100010000000010
0101111111110111111011111111010
0100000000000100000000000000010
0104000000030010000400003000010
0111111111111111111111111111110
MAX_WATER=400
MAX_STRESS=140
BLOCK_LIFE=300
STAGE_GOAL=180
CLEAR_RATE=0.55
