1000000000000000000000000000001
0111111111111111111111111111110
0100000000000000000000000000010
0100000000000002000000000000010
0100000000000000000000000000010
0100000000000000000000000000010
0100000000000000000000000000010
0100000000010000000100000000010
0100000001110000000111000000010
0100000110010000000100110000010
0100001000010001000100001000010
0100000000010000000100000000010
0100000000001000001000000000010
0100000000001000001000000000010
0100000000001000001000000000010
0100000000000110110000000000010
0100000000000003000001000000010
0100000000000000000001000000010
0100000001000000000011100000010
0104000001000000000011100003010
0100000011100000000111110000010
0111111111111111111111111111110
1000000000000000000000000000001
MAX_WATER=400
MAX_STRESS=250
BLOCK_LIFE=300
STAGE_GOAL=200
CLEAR_RATE=0.5